1111111111111111111111111111111
1PC00N00100C000000001010001E001
110000NC1000N000000000100011011
10C001100100C00C000000C0N000001
10N01C110101000000000011111C101
10000000000C0100100N001C0001101
1111011111111111111111111011101
1010001100010000010000100010001
1000100001000111000010000000101
1111111111111111111111111111111