1111111111111111111111111111111
1PC00000100C000000001010001E001
1100000C10000000000000100011011
10C001100100C00C000000C00000001
10001C110101000000000011111C101
10000000000C00000000001C0001101
1111011111111111111111111011101
1010001100010000010000100010001
1000100001000111000010000000101
1111111111111111111111111111111
